0,0,1,1,0,0,0,0,1,1,0,0,2,3
1,1,1,0,0,1,0,0,1,1,0,0,4,5
0,1,0,1,0,1,0,0,1,1,0,0,1,3
0,1,1,0,1,1,1,0,1,0,1,1,5,2
1,0,1,0,1,1,1,0,1,0,1,1,1,1
1,1,1,1,1,1,1,0,1,0,1,1,4,4
