col1,col2,col3,col4,col5,col6
1,0,1,1,0,0
1,1,1,0,1,1
1,1,1,1,1,1
1,1,1,0,1,1
1,0,1,0,1,1
0,0,1,1,0,0
